111111101111111
100000101000001
101110101111101
101010100000101
101010111110101
101000000000101
111011111111101
100000100000001
101110101111111
101010100000001
101010111111101
100010001000101
111110101010101
100010101010101
101110111010101
100000000010001
111111111011111